3,3,3,3,3,3,3,3,3,3,3,3,3,3,3,3,3,3,3,3,3,3,3,3,3,3,3,3,3,3,3,3,3,3,3,3,3,3,3,3,3,3,3,3,3,3,3,3,3,3,3,3,3,3,3,3,3,3,3,3,
3,3,3,3,3,3,3,3,3,3,3,3,3,3,3,3,3,3,3,3,3,3,3,3,3,3,3,3,3,3,3,3,3,3,3,3,3,3,3,3,3,3,3,3,3,3,3,3,3,3,3,3,3,3,3,3,3,3,3,3,
3,3,3,3,3,3,3,3,3,3,3,3,3,3,3,3,3,3,3,3,3,3,3,3,3,3,3,3,3,3,3,3,3,3,3,3,3,3,3,3,3,3,3,3,3,3,3,3,3,3,3,3,3,3,3,3,3,3,3,3,
3,3,3,3,3,3,3,3,3,3,3,3,3,3,3,3,3,3,3,3,3,3,3,3,3,3,3,3,3,3,3,3,3,3,3,3,3,3,3,3,3,3,3,3,3,3,3,3,3,3,3,3,3,3,3,3,3,3,3,3,
3,3,3,3,3,3,3,3,3,3,3,3,3,3,3,3,3,3,3,3,3,3,3,3,3,3,3,3,3,3,3,3,3,3,3,3,3,3,3,3,3,3,3,3,3,3,3,3,3,3,3,3,3,3,3,3,3,3,3,3,
3,3,3,3,3,3,3,3,3,3,3,3,3,3,3,3,3,3,3,3,3,3,3,3,3,3,3,3,3,3,3,3,3,3,3,3,3,3,3,3,3,3,3,3,3,3,3,3,3,3,3,3,3,3,3,3,3,3,3,3,
3,3,3,3,3,3,3,3,3,3,3,3,3,3,3,3,3,3,3,3,3,3,3,3,3,3,3,3,3,3,3,3,3,3,3,3,3,3,3,3,3,3,3,3,3,3,3,3,3,3,3,3,3,3,3,3,3,3,3,3,
3,3,3,3,3,3,3,3,3,3,3,3,3,3,3,3,3,3,3,3,3,3,3,3,3,3,3,3,3,3,3,3,3,3,3,3,3,3,3,3,3,3,3,3,3,3,3,3,3,3,3,3,3,3,3,3,3,3,3,3,
3,3,3,3,3,3,3,3,3,3,3,3,3,3,3,3,3,3,3,3,3,3,3,3,3,3,3,3,3,3,3,3,3,3,3,3,3,3,3,3,3,3,3,3,3,3,3,3,3,3,3,3,3,3,3,3,3,3,3,3,
3,3,3,3,3,3,3,3,3,3,3,3,3,3,3,3,3,3,3,3,3,3,3,3,3,3,3,3,3,3,3,3,3,3,3,3,3,3,3,3,3,3,3,3,3,3,3,3,3,3,3,3,3,3,3,3,3,3,3,3,
3,3,3,3,3,3,3,3,3,3,4,4,4,4,4,4,4,4,4,4,4,4,4,4,4,4,4,4,4,4,4,4,4,4,4,4,4,4,4,4,4,4,4,4,4,4,4,4,4,4,3,3,3,3,3,3,3,3,3,3,
3,3,3,3,3,3,3,3,3,3,4,6,6,6,6,6,6,6,6,4,4,4,4,4,4,4,4,4,4,4,4,4,4,4,4,4,4,6,6,6,6,6,6,6,6,6,6,6,6,4,3,3,3,3,3,3,3,3,3,3,
3,3,3,3,3,3,3,3,3,3,4,6,6,6,6,6,6,6,6,4,4,4,4,4,4,4,4,4,4,4,4,4,4,4,4,4,4,6,6,6,6,6,7,7,7,7,7,7,6,4,3,3,3,3,3,3,3,3,3,3,
3,3,3,3,3,3,3,3,3,3,4,6,6,6,6,6,6,6,6,4,4,4,6,6,6,6,6,6,6,6,6,6,6,6,4,4,4,6,6,6,6,6,7,7,7,7,7,7,6,4,3,3,3,3,3,3,3,3,3,3,
3,3,3,3,3,3,3,3,3,3,4,6,6,6,6,6,6,6,6,4,4,4,6,6,6,6,6,6,6,6,6,6,6,6,4,4,4,6,6,6,6,6,7,7,7,7,7,7,6,4,3,3,3,3,3,3,3,3,3,3,
3,3,3,3,3,3,3,3,3,3,4,6,6,6,6,6,6,6,6,4,4,4,6,6,6,6,6,6,6,6,6,6,6,6,6,6,4,6,6,6,6,6,7,7,7,7,7,7,6,4,3,3,3,3,3,3,3,3,3,3,
3,3,3,3,3,3,3,3,3,3,4,6,6,6,6,6,6,6,6,4,4,4,6,6,6,6,6,6,6,6,6,6,6,6,6,6,8,6,6,6,6,6,7,7,7,7,7,7,6,4,3,3,3,3,3,3,3,3,3,3,
3,3,3,3,3,3,3,3,3,3,4,6,6,6,6,6,6,6,6,4,4,4,6,6,6,6,6,6,6,6,6,6,6,6,6,6,8,6,6,6,6,6,7,7,7,7,7,7,6,4,3,3,3,3,3,3,3,3,3,3,
3,3,3,3,3,3,3,3,3,3,4,6,6,6,6,6,6,6,6,4,4,4,6,6,6,6,6,6,6,6,6,6,6,6,6,6,4,6,6,6,6,6,6,6,6,6,6,6,6,4,3,3,3,3,3,3,3,3,3,3,
3,3,3,3,3,3,3,3,3,3,4,4,4,4,8,8,4,4,4,4,4,4,6,6,6,6,6,6,6,6,6,6,6,6,4,4,4,6,6,6,6,6,6,6,6,6,6,6,6,4,3,3,3,3,3,3,3,3,3,3,
3,3,3,3,3,3,3,3,3,3,4,4,4,6,6,6,6,4,4,4,4,4,6,6,6,6,6,6,6,6,6,6,6,6,4,4,4,6,6,6,6,6,6,6,6,6,6,6,6,4,3,3,3,3,3,3,3,3,3,3,
3,3,3,3,3,3,3,3,3,3,4,4,4,6,6,6,6,4,4,4,4,4,6,6,6,6,6,6,6,6,6,6,6,6,4,4,4,6,6,6,6,6,6,6,6,6,6,6,6,4,3,3,3,3,3,3,3,3,3,3,
3,3,3,3,3,3,3,3,3,3,4,4,4,6,6,6,6,4,4,4,4,4,6,6,6,6,6,6,6,6,6,6,6,6,4,4,4,6,6,6,6,6,6,6,6,6,6,6,6,4,3,3,3,3,3,3,3,3,3,3,
3,3,3,3,3,3,3,3,3,3,4,4,4,6,6,6,6,4,4,4,4,4,6,6,6,6,6,6,6,6,6,6,6,6,4,4,4,4,4,4,4,4,4,4,4,8,8,4,4,4,3,3,3,3,3,3,3,3,3,3,
3,3,3,3,3,3,3,3,3,3,4,4,4,6,6,6,6,4,4,4,4,4,6,6,6,6,6,6,6,6,6,6,6,6,4,4,4,6,6,6,6,4,6,6,6,6,6,6,6,4,3,3,3,3,3,3,3,3,3,3,
3,3,3,3,3,3,3,3,3,3,4,4,4,6,6,6,6,4,4,4,4,4,6,6,6,6,6,6,6,6,6,6,6,6,4,4,4,6,6,6,6,4,6,6,6,6,6,6,6,4,3,3,3,3,3,3,3,3,3,3,
3,3,3,3,3,3,3,3,3,3,4,4,4,6,6,6,6,4,4,4,4,4,6,6,6,6,6,6,6,6,6,6,6,6,4,4,4,6,6,6,6,4,6,6,6,6,6,6,6,4,3,3,3,3,3,3,3,3,3,3,
3,3,3,3,3,3,3,3,3,3,4,4,4,6,6,6,6,4,4,4,4,4,6,6,6,6,6,6,6,6,6,6,6,6,4,4,4,6,6,6,6,4,6,6,6,6,6,6,6,4,3,3,3,3,3,3,3,3,3,3,
3,3,3,3,3,3,3,3,3,3,4,4,4,6,6,6,6,4,4,4,4,4,4,4,4,4,4,4,4,4,4,4,8,8,4,4,4,6,6,6,6,4,6,6,6,6,6,6,6,4,3,3,3,3,3,3,3,3,3,3,
3,3,3,3,3,3,3,3,3,3,4,4,4,6,6,6,6,4,4,4,6,6,6,6,6,6,6,6,6,6,6,6,6,6,4,4,4,6,6,6,6,4,6,6,6,6,6,6,6,4,3,3,3,3,3,3,3,3,3,3,
3,3,3,3,3,3,3,3,3,3,4,4,4,6,6,6,6,4,4,4,6,6,6,6,6,6,6,6,6,6,6,6,6,6,4,4,4,6,6,6,6,4,6,6,6,6,6,6,6,4,3,3,3,3,3,3,3,3,3,3,
3,3,3,3,3,3,3,3,3,3,4,4,4,6,6,6,6,4,4,4,6,6,6,6,6,6,6,6,6,6,6,6,6,6,4,4,4,6,6,6,6,4,6,6,6,6,6,6,6,4,3,3,3,3,3,3,3,3,3,3,
3,3,3,3,3,3,3,3,3,3,4,4,4,6,6,6,6,4,4,4,6,6,6,6,6,6,6,6,6,6,6,6,6,6,4,4,4,6,6,6,6,4,6,6,6,6,6,6,6,4,3,3,3,3,3,3,3,3,3,3,
3,3,3,3,3,3,3,3,3,3,4,4,4,6,6,6,6,4,4,4,6,6,6,6,6,6,6,6,6,6,6,6,6,6,4,4,4,6,6,6,6,4,6,6,6,6,6,6,6,4,3,3,3,3,3,3,3,3,3,3,
3,3,3,3,3,3,3,3,3,3,4,4,4,6,6,6,6,4,4,4,6,6,6,6,6,6,6,6,6,6,6,6,6,6,4,4,4,6,6,6,6,4,6,6,6,6,6,6,6,4,3,3,3,3,3,3,3,3,3,3,
3,3,3,3,3,3,3,3,3,3,4,4,4,6,6,6,6,4,4,4,6,6,6,6,6,6,6,6,6,6,6,6,6,6,4,4,4,6,6,6,6,4,6,6,6,6,6,6,6,4,3,3,3,3,3,3,3,3,3,3,
3,3,3,3,3,3,3,3,3,3,4,4,4,6,6,6,6,4,4,4,6,6,6,6,6,6,6,6,6,6,6,6,6,6,4,4,4,6,6,6,6,8,6,6,6,6,6,6,6,4,3,3,3,3,3,3,3,3,3,3,
3,3,3,3,3,3,3,3,3,3,4,4,4,6,6,6,6,4,4,4,6,6,6,6,6,6,6,6,6,6,6,6,6,6,4,4,4,6,6,6,6,8,6,6,6,6,6,6,6,4,3,3,3,3,3,3,3,3,3,3,
3,3,3,3,3,3,3,3,3,3,4,4,4,6,6,6,6,4,4,4,6,6,6,6,6,6,6,6,6,6,6,6,6,6,4,4,4,6,6,6,6,4,6,6,6,6,6,6,6,4,3,3,3,3,3,3,3,3,3,3,
3,3,3,3,3,3,3,3,3,3,4,4,4,6,6,6,6,4,4,4,6,6,6,6,6,6,6,6,6,6,6,6,6,6,4,4,4,6,6,6,6,4,6,6,6,6,6,6,6,4,3,3,3,3,3,3,3,3,3,3,
3,3,3,3,3,3,3,3,3,3,4,4,4,6,6,6,6,4,4,4,4,4,4,4,4,4,4,4,4,4,4,4,4,4,4,4,4,6,6,6,6,4,6,6,6,6,6,6,6,4,3,3,3,3,3,3,3,3,3,3,
3,3,3,3,3,3,3,3,3,3,4,4,4,6,6,6,6,4,4,4,4,4,4,4,4,4,4,4,4,4,4,4,4,4,4,4,4,6,6,6,6,4,6,6,6,6,6,6,6,4,3,3,3,3,3,3,3,3,3,3,
3,3,3,3,3,3,3,3,3,3,4,4,4,6,6,6,6,4,4,4,4,4,4,4,4,4,4,4,4,4,4,4,4,4,4,4,4,6,6,6,6,4,6,6,6,6,6,6,6,4,3,3,3,3,3,3,3,3,3,3,
3,3,3,3,3,3,3,3,3,3,4,4,4,6,6,6,6,6,6,6,6,6,6,6,6,6,6,6,6,6,6,6,6,6,6,6,4,6,6,6,6,4,6,6,6,6,6,6,6,4,3,3,3,3,3,3,3,3,3,3,
3,3,3,3,3,3,3,3,3,3,4,4,4,6,6,6,6,6,6,6,6,6,6,6,6,6,6,6,6,6,6,6,6,6,6,6,8,6,6,6,6,4,6,6,6,6,6,6,6,4,3,3,3,3,3,3,3,3,3,3,
3,3,3,3,3,3,3,3,3,3,4,4,4,6,6,6,6,6,6,6,6,6,6,6,6,6,6,6,6,6,6,6,6,6,6,6,8,6,6,6,6,4,6,6,6,6,6,6,6,4,3,3,3,3,3,3,3,3,3,3,
3,3,3,3,3,3,3,3,3,3,4,4,4,6,6,6,6,6,6,6,6,6,6,6,6,6,6,6,6,6,6,6,6,6,6,6,4,6,6,6,6,4,6,6,6,6,6,6,6,4,3,3,3,3,3,3,3,3,3,3,
3,3,3,3,3,3,3,3,3,3,4,4,4,4,4,4,4,4,4,4,4,4,4,4,4,4,4,4,4,4,4,4,4,4,4,4,4,6,6,6,6,4,6,6,6,6,6,6,6,4,3,3,3,3,3,3,3,3,3,3,
3,3,3,3,3,3,3,3,3,3,4,4,4,4,4,4,4,4,4,4,4,4,4,4,4,4,4,4,4,4,4,4,4,4,4,4,4,6,6,6,6,4,6,6,6,6,6,6,6,4,3,3,3,3,3,3,3,3,3,3,
3,3,3,3,3,3,3,3,3,3,4,4,4,4,4,4,4,4,4,4,4,4,4,4,4,4,4,4,4,4,4,4,4,4,4,4,4,4,4,4,4,4,4,4,4,4,4,4,4,4,3,3,3,3,3,3,3,3,3,3,
3,3,3,3,3,3,3,3,3,3,3,3,3,3,3,3,3,3,3,3,3,3,3,3,3,3,3,3,3,3,3,3,3,3,3,3,3,3,3,3,3,3,3,3,3,3,3,3,3,3,3,3,3,3,3,3,3,3,3,3,
3,3,3,3,3,3,3,3,3,3,3,3,3,3,3,3,3,3,3,3,3,3,3,3,3,3,3,3,3,3,3,3,3,3,3,3,3,3,3,3,3,3,3,3,3,3,3,3,3,3,3,3,3,3,3,3,3,3,3,3,
3,3,3,3,3,3,3,3,3,3,3,3,3,3,3,3,3,3,3,3,3,3,3,3,3,3,3,3,3,3,3,3,3,3,3,3,3,3,3,3,3,3,3,3,3,3,3,3,3,3,3,3,3,3,3,3,3,3,3,3,
3,3,3,3,3,3,3,3,3,3,3,3,3,3,3,3,3,3,3,3,3,3,3,3,3,3,3,3,3,3,3,3,3,3,3,3,3,3,3,3,3,3,3,3,3,3,3,3,3,3,3,3,3,3,3,3,3,3,3,3,
3,3,3,3,3,3,3,3,3,3,3,3,3,3,3,3,3,3,3,3,3,3,3,3,3,3,3,3,3,3,3,3,3,3,3,3,3,3,3,3,3,3,3,3,3,3,3,3,3,3,3,3,3,3,3,3,3,3,3,3,
3,3,3,3,3,3,3,3,3,3,3,3,3,3,3,3,3,3,3,3,3,3,3,3,3,3,3,3,3,3,3,3,3,3,3,3,3,3,3,3,3,3,3,3,3,3,3,3,3,3,3,3,3,3,3,3,3,3,3,3,
3,3,3,3,3,3,3,3,3,3,3,3,3,3,3,3,3,3,3,3,3,3,3,3,3,3,3,3,3,3,3,3,3,3,3,3,3,3,3,3,3,3,3,3,3,3,3,3,3,3,3,3,3,3,3,3,3,3,3,3,
3,3,3,3,3,3,3,3,3,3,3,3,3,3,3,3,3,3,3,3,3,3,3,3,3,3,3,3,3,3,3,3,3,3,3,3,3,3,3,3,3,3,3,3,3,3,3,3,3,3,3,3,3,3,3,3,3,3,3,3,
3,3,3,3,3,3,3,3,3,3,3,3,3,3,3,3,3,3,3,3,3,3,3,3,3,3,3,3,3,3,3,3,3,3,3,3,3,3,3,3,3,3,3,3,3,3,3,3,3,3,3,3,3,3,3,3,3,3,3,3,
3,3,3,3,3,3,3,3,3,3,3,3,3,3,3,3,3,3,3,3,3,3,3,3,3,3,3,3,3,3,3,3,3,3,3,3,3,3,3,3,3,3,3,3,3,3,3,3,3,3,3,3,3,3,3,3,3,3,3,3